A casa - Vinícius de Moraes
Acontece que - Affonsinho
Asa Branca
Casa pré-fabricada - Los Hermanos
Cinema Paradiso (Love Theme) - LOW G - Ennio Morricone
Como é grande o meu amor por você - Roberto Carlos
De onde vem a calma - Los Hermanos
Desculpe, mas eu vou chorar - LOW G - Leandro e Leonardo
Despedida - Roberto Carlos
E por isso eu estou aqui - Roberto Carlos
Eleanor Rigby - The Beatles
Eu só quero um xodó - Dominguinhos e Anastácia
Frisson - Tunai
It's my life - LOW G - Talk, Talk / No Doubt
La edad del cielo - Jorge Drexler
Lilás - Djavan 
Love Hurts - Nazareth
Lua de São Jorge - Caetano Veloso
Marinheiro - Alexandre Amaro
Mele Kalikimaka - Robert Alexander Anderson
Meu bem querer - LOW G - Djavan
Meu mundo e nada mais - Guilherme Arantes
O exército de um homem só - Engenheiros do Hawaii
Onde Deus possa me ouvir - Vander Lee
Onde estará o meu amor - Chico César
Paisagem da Janela - Lô e Márcio Borges
Pensando em você - Paulinho Moska
Quando Chega - Trívula
Quem sabe isso quer dizer amor - Milton Nascimento
Qui nem Jiló - Luiz Gonzaga
Raindrops Keep falling on my head - B.J. Thomas
Se não vira Jazz - Low G - Djavan
Ska - Os Paralamas do Sucesso
Sobre o Tempo - Nenhum de Nós
Tears od the dragon - LOW G - Bruce Dickinson
Tender - LOW G -Blur
Todo azul do mar - 14 Bis
Vamo Pulá - Sandy e Jr.
Wicked Heart - Tristen
Woman - John Lennon
You only live once - The Strokes



Em processo de Revisão (Podem ser solicitadas)

(Oxalá ( Campanella acompanhada de piano))
(Ícaro - Péricles Garcia)
(Lanterna dos Afogados - Os Paralamas do Sucesso)
(Go Back - Titãs)
(Fullgás - LOW G -Marina Lima)

Em breve...

(Além dos outdoors - Engenheiros do Hawaii)
(Black Hole Sun - Soundgarden)
(Close to You - The Carpenters)
(Fado Tropical - Chico Buarque de Holanda)
(Final Feliz - Jorge Vercillo)
(Let it be - The Beatles)
(Manuel, o Audaz - Toninho Horta)
(Longview - Greenday)
(Luiza - Tom Jobim)
(Meus bons amigos - Barão Vermelho)
(Oh my Love - John Lennon)
(Sapato velho - Roupa Nova)
(Ursinho Pimpão - A Turma do Balão Mágico)
(Sir Duke - Stevie Wonder)